"filename", "language", "Python", "Markdown", "comment", "blank", "total"
"e:\HUBOther\ML_Sys_Merak\TorchGraph\DDP_graph.py", "Python", 140, 0, 20, 35, 195
"e:\HUBOther\ML_Sys_Merak\TorchGraph\DDP_test.py", "Python", 20, 0, 15, 11, 46
"e:\HUBOther\ML_Sys_Merak\TorchGraph\DDP_torch_database.py", "Python", 4, 0, 0, 1, 5
"e:\HUBOther\ML_Sys_Merak\TorchGraph\DDP_torch_database_test.py", "Python", 17, 0, 20, 9, 46
"e:\HUBOther\ML_Sys_Merak\TorchGraph\Node.py", "Python", 75, 0, 0, 19, 94
"e:\HUBOther\ML_Sys_Merak\TorchGraph\README.md", "Markdown", 0, 31, 0, 15, 46
"e:\HUBOther\ML_Sys_Merak\TorchGraph\ref.py", "Python", 357, 0, 7, 81, 445
"e:\HUBOther\ML_Sys_Merak\TorchGraph\shape_prop.py", "Python", 56, 0, 60, 20, 136
"e:\HUBOther\ML_Sys_Merak\TorchGraph\timer copy 2.py", "Python", 93, 0, 15, 30, 138
"e:\HUBOther\ML_Sys_Merak\TorchGraph\timer copy.py", "Python", 128, 0, 15, 31, 174
"e:\HUBOther\ML_Sys_Merak\TorchGraph\timer.py", "Python", 140, 0, 15, 34, 189
"e:\HUBOther\ML_Sys_Merak\TorchGraph\tmp.py", "Python", 317, 0, 12, 68, 397
"e:\HUBOther\ML_Sys_Merak\TorchGraph\torch_database.py", "Python", 105, 0, 27, 30, 162
"e:\HUBOther\ML_Sys_Merak\TorchGraph\torch_database_test.py", "Python", 24, 0, 3, 7, 34
"e:\HUBOther\ML_Sys_Merak\TorchGraph\torch_graph.py", "Python", 331, 0, 14, 72, 417
"e:\HUBOther\ML_Sys_Merak\TorchGraph\torch_graph_test.py", "Python", 17, 0, 2, 7, 26
"e:\HUBOther\ML_Sys_Merak\TorchGraph\torch_real.py", "Python", 39, 0, 16, 14, 69
"e:\HUBOther\ML_Sys_Merak\TorchGraph\transformer\gpt2.py", "Python", 35, 0, 14, 9, 58
"e:\HUBOther\ML_Sys_Merak\TorchGraph\typename.py", "Python", 25, 0, 1, 5, 31
"Total", "-", 1923, 31, 256, 498, 2708